CONTENTS OF FLX FILE (103 Variables)
CDUVBsfc	surface Clear Sky UV-B Downward Solar Flux [W/m^2]
DUVBsfc	surface UV-B Downward Solar Flux [W/m^2]
CSDLFsfc	surface Clear sky downward long wave flux [W/m^2]
CSDSFsfc	surface Clear sky downward solar flux [W/m^2]
CSULFsfc	surface Clear sky upward long wave flux [W/m^2]
CSULFtoa	top of atmos Clear sky upward long wave flux [W/m^2]
CSUSFsfc	surface Clear sky upward solar flux [W/m^2]
CSUSFtoa	top of atmos Clear sky upward solar flux [W/m^2]
NBDSFsfc	surface Near IR beam downward solar flux [W/m^2]
NDDSFsfc	surface Near IR diffuse downward solar flux [W/m^2]
VBDSFsfc	surface Visible beam downward solar flux [W/m^2]
VDDSFsfc	surface Visible diffuse downward solar flux [W/m^2]
DLWRFsfc	surface Downward long wave flux [W/m^2]
DSWRFsfc	surface Downward short wave flux [W/m^2]
DSWRFtoa	top of atmos Downward short wave flux [W/m^2]
LHTFLsfc	surface Latent heat flux [W/m^2]
SHTFLsfc	surface Sensible heat flux [W/m^2]
ULWRFsfc	surface Upward long wave flux [W/m^2]
ULWRFtoa	top of atmos Upward long wave flux [W/m^2]
USWRFsfc	surface Upward short wave flux [W/m^2]
USWRFtoa	top of atmos Upward short wave flux [W/m^2]
CNWATsfc	surface Plant canopy surface water [kg/m^2]
EVBSsfc	surface Direct evaporation from bare soil [W/m^2]
EVCWsfc	surface Canopy water evaporation [W/m^2]
SBSNOsfc	surface Sublimation (evaporation from snow) [W/m^2]
SFCRsfc 	surface Surface roughness [m]
SFEXCsfc	surface Exchange coefficient [(kg/m^3)(m/s)]
SLTYPsfc	surface Surface slope type [Index]
SNODsfc 	surface Snow depth [m]
SNOHFsfc	surface Snow phase-change heat flux [W/m^2]
SNOWCsfc	surface Snow cover [%]
GFLUXsfc	surface Ground heat flux [W/m^2]
SOTYPsfc	surface Soil type (Zobler) [0..9]
SRWEQsfc	surface Snowfall rate water equiv. [kg/m^2/s]
SSRUNsfc	surface Storm surface runoff [kg/m^2]
PEVPRsfc	surface Potential evaporation rate [W/m^2]
TRANSsfc	surface Transpiration [W/m^2]
VEGsfc	surface Vegetation [%]
VGTYPsfc	surface Vegetation type (as in SiB) [0..13]
WATRsfc 	surface Water runoff [kg/m^2]
WEASDsfc	surface Accum. snow [kg/m^2]
TMP_10cm		0-10 cm underground Temp. [K]
TMP10_40cm		10-40 cm underground Temp. [K]
TMP40_100cm		40-100 cm underground Temp. [K]
TMP100_200cm	100-200 cm underground Temp. [K]
SOILL0_10cm		0-10 cm underground Liquid volumetric soil moisture	(non-frozen)
SOILL10_40cm	10-40 cm underground Liquid volumetric soil moisture	(non-frozen)
SOILL40_100cm	40-100 cm underground Liquid volumetric soil moisture (non-frozen)
SOILL100_200cm	100-200 cm underground Liquid volumetric soil moisture (non-frozen)
SOILM0_200cm	0-200 cm underground Soil moisture content [kg/m^2]
SOILW0_10cm		0-10 cm underground Volumetric soil moisture [fraction]
SOILW10_40cm	10-40 cm underground Volumetric soil moisture [fraction]
SOILW40_100cm	40-100 cm underground Volumetric soil moisture [fraction]
SOILW100_200cm 	100-200 cm underground Volumetric soil moisture [fraction]
CRAINsfc	surface Categorical rain [yes=1;no=0]
CWORKclm	atmos column Cloud work function [J/kg]
CPRATsfc	surface Convective precip. rate [kg/m^2/s]
PRATEsfc	surface Precipitation rate [kg/m^2/s]
PRESlcb	low cloud base Pressure [Pa]
PRESlct	low cloud top Pressure [Pa]
PRESmcb	mid-cloud base Pressure [Pa]
PRESmct	mid-cloud top Pressure [Pa]
PREShcb	high cloud base Pressure [Pa]
PREShct	high cloud top Pressure [Pa]
PREScvb	convective cld base Pressure [Pa]
PREScvt	convective cld top Pressure [Pa]
TCDCclm	atmos column Total cloud cover [%]
TCDCbcl	boundary cld layer Total cloud cover [%]
TCDClcl	low cloud level Total cloud cover [%]
TCDCmcl	mid-cloud level Total cloud cover [%]
TCDChcl	high cloud level Total cloud cover [%]
TCDCcvl	convective cld layer Total cloud cover [%]
TMPlct	low cloud top Temp. [K]
TMPmct	mid-cloud top Temp. [K]
TMPhct	high cloud top Temp. [K]
TMAX2m	2 m above ground Max. temp. [K]
TMIN2m	2 m above ground Min. temp. [K]
TMPsfc	surface Temp. [K]
TMP2m 	2 m above ground Temp. [K]
TMPhlev1	hybrid level 1 Temp. [K]
PWATclm	atmos column Precipitable water [kg/m^2]
QMAX2m	2 m above ground Maximum specific humidity at 2m
QMIN2m	2 m above ground Minimum specific humidity at 2m
SPFH2m	2 m above ground Specific humidity [kg/kg]
SPFHhlev1	hybrid level 1 Specific humidity [kg/kg]
UGWDsfc	surface Zonal gravity wave stress [N/m^2]
VGWDsfc	surface Meridional gravity wave stress [N/m^2]
UFLXsfc	surface Zonal momentum flux [N/m^2]
VFLXsfc	surface Meridional momentum flux [N/m^2]
UGRD10m	10 m above ground u wind [m/s]
VGRD10m	10 m above ground v wind [m/s]
UGRDhlev1	hybrid level 1 u wind [m/s]
VGRDhlev1	hybrid level 1 v wind [m/s]
ICECsfc	surface Ice concentration (ice=1;no ice=0) [fraction]
ICETKsfc	surface Ice thickness [m]
LANDsfc	surface Land cover (land=1;sea=0) [fraction]
ACONDsfc	surface Aerodynamic conductance [m/s]
ALBDOsfc	surface Albedo [%]
FRICVsfc	surface Friction velocity [m/s]
HGTsfc	surface Geopotential height [gpm]
HGThlev1	hybrid level 1 Geopotential height [gpm]
HPBLsfc	surface Planetary boundary layer height [m]
PRESsfc	surface Pressure [Pa]

